:--:--:--:--:--:--:--:--:--:--:--:--:--:--:--:  
|              |                             |  
:  :--:--:--:  :--:--:--:--:  :--:--:  :--:  :  
|           |                 |        |     |  
:  :--:--:  :--:--:--:--:  :--:--:--:--:--:--:  
|  |     |  |           |  |                 |  
:  :  :  :  :  :  :--:  :  :  :--:--:--:--:  :  
|  |  |  |  |  |  |     |  |  |  |        |  |  
:  :  :--:  :  :--:--:--:  :  :  :--:  :  :  :  
|  |     |  |              |           |  |  |  
:  :--:  :  :--:--:--:--:--:  :--:--:--:--:  :  
|     |  |                    |              |  
:--:  :  :--:--:--:--:--:--:--:  :--:--:--:  :  
|  |  |                    |     |     |  |  |  
:  :  :--:  :--:--:--:--:  :  :--:  :  :  :  :  
|  |  |     |     |     |  |  |     |     |  |  
:  :  :  :--:--:  :--:  :  :  :  :--:--:--:  :  
|     |  |              |  |  |              |  
:--:  :  :  :--:--:--:  :  :  :  :--:--:--:--:  
|  |  |  |  |  | O   |  |  |  |  |           |  
:  :  :  :  :  :--:  :  :  :  :  :  :--:--:  :  
|  |  |  |  |        |  |  |  |  |  |     |  |  
:  :  :  :  :  :--:--:  :  :  :  :  :  :  :  :  
|  |  |  |  |           |  |  |  |  |  |  |  |  
:  :  :  :  :--:--:--:--:  :  :  :  :--:  :  :  
|     |  |                 |  |  |        |  |  
:  :--:  :  :--:--:--:--:--:  :  :--:--:  :  :  
|  |     |  |        |        |     |     |  |  
:  :--:  :  :--:--:  :  :--:--:--:  :--:--:  :  
|        |           |  |                    |  
:--:--:--:--:--:--:--:  :--:--:--:--:--:--:--:
