___________________________________  
| _____ |   | ___ | ___ ___ | |   | |
| |   | |_| |__ | |_| __|____ | | | |
| | | |_________|__ |______ |___|_| |
| |_|   | _______ |______ |   | ____|
| ___ | |____ | |______ | |_| |____ |
|___|_|____ | |   ___ | |________ | |
|   ________| | |__ | |______ | | | |
| | | ________| | __|____ | | | __| |
|_| |__ |   | __|__ | ____| | |_| __|
|   ____| | |____ | |__ |   |__ |__ |
| |_______|_______|___|___|___|_____|

