,--------------.-----------------------------.  
|              |                             |  
|   --------.  `-----------   ,-----   ,--   |  
|           |                 |        |     |  
|  ,-----.  :-----------.  ,--"--------"-----:  
|  |     |  |           |  |                 |  
|  |  .  |  |  .  ,--   |  |  ,--.--------.  |  
|  |  |  |  |  |  |     |  |  |  |        |  |  
|  |  `--:  |  `--"-----'  |  "  `--   .  |  |  
|  |     |  |              |           |  |  |  
|  `--.  |  `--------------'  ,--------"--'  |  
|     |  |                    |              |  
:--.  |  `-----------------.--'  ,-----.--.  |  
|  |  |                    |     |     |  |  |  
|  |  :--   ,-----.-----.  |  ,--'  .  "  |  |  
|  |  |     |     |     |  |  |     |     |  |  
|  "  |  ,--"--   `--   |  |  |   --"-----'  |  
|     |  |              |  |  |              |  
:--.  |  |  ,--.-----.  |  |  |  ,-----------:  
|  |  |  |  |  | X   |  |  |  |  |           |  
|  |  |  |  |  `--   |  |  |  |  |  ,-----.  |  
|  |  |  |  |        |  |  |  |  |  |     |  |  
|  |  |  |  |   -----'  |  |  |  |  |  .  |  |  
|  |  |  |  |           |  |  |  |  |  |  |  |  
|  "  |  |  `-----------'  |  |  |  `--'  |  |  
|     |  |                 |  |  |        |  |  
|  ,--'  |  ,--------.-----'  |  `--.--   |  |  
|  |     |  |        |        |     |     |  |  
|  `--   |  `-----   |  ,-----"--   `-----'  |  
|        |           |  |                    |  
`--------"-----------'  `--------------------'

